#######D#######
#.............#
#.............#
#.............#
#.............#
D.............D
#.............#
#.............#
#.............#
#.............#
#######D#######