#######D#######
#.............#
#.............#
#.............#
#.....___.....#
D.....___.....D
#.....___.....#
#.............#
#.............#
#.............#
#######D#######